# ################## # # # #
#                    # # # #
# ################## # # # #
# ################## # # # #
#                    # # # #
# ################## # # # #
#   ##        #      # # # #
# # ## # ### #  ###### # # #
# #    #    ##B#     # # # #
# # ## ######### ##### # # #
### ##            #### # # #
### ############# ## # # # #
###            ##    # # # #
###### ####### ####### # # #
###### ####            #   #
A      #####################